NO       ./textures/backrooms.xpm
WE    textures/backrooms.xpm
SO  textures/backrooms.xpm
EA       textures/backrooms.xpm
C     255,200,200
F     122,122,122


11111111111111111
10000000000000001
10100000100000101
10000S00001000001
10001100100010001
10000000000000001
10101011001010101
10000000100000001
10001000100100001
10000000100100001
10100000100001001
10000000000000001
11111111111111111
